NO textures/wolfenstein/purple_stone.xpm
SO textures/wolfenstein/red_brick.xpm
WE textures/wolfenstein/blue_stone.xpm
EA textures/wolfenstein/mossy.xpm

C 53,41,34
F 45,33,27

111111
1S0001
10111111
101 1001
111111111