


NO ./path_to_the_north_texture
SO ./path_to_the_south_texture
WE ./path_to_the_west_texture


EA ./path_to_the_east_texture



F 255,100,0 
C 255,30,0


        1111111111111111111111111
        1000000000110000000000001
        1011000001110000000000001
        1001000000000000000000001
111111111011000001110000000000001
100000000011000001110111111111111
111101111111110111111111001000111111
1111011111111101       10111010010001
110000001101010111111111100011111111
10000000000000001100000011111
10000000000000001101010010001
11000001110101011111011110S0111
11110111 1110101 101111010001
11111111 1111111 111111111111


