111111
100001
10111111
101 1001
111111111