   WE                            textures/wolfenstein/grey_stone.xpm
NO      textures/wolfenstein/purple_stone.xpm



SO textures/wolfenstein/red_brick.xpm

F      17,    38,     64

EA textures/wolfenstein/wood.xpm



C 218, 234, 235

1111111111111111111111111
1000110000100000000000001
100000000001000S000000001
1000000000000000000000001
1000000000000010000000001
1000000000000010000000001
1000000000000010000000001
1000000000000010000000001
1000110000000000111111001
1000110000000000110001001
1000000000100000000001001
1111111111111111111111111
