F 76,76,76
C 99,99,99

NO textures/wolfenstein/mossy.xpm
SO textures/wolfenstein/eagle.xpm
WE textures/wolfenstein/purple_stone.xpm
EA textures/wolfenstein/grey_stone.xpm

1111111111111111111
1001001001001000001
1011000001000001001
1001001001111101111
1111111111111111D11
1000000000000001001
1000000000000001001
100000W000000001001
1000000000000001001
111111D111111111D11
1111000000000001011
1000000001000000001
1111111111111111111

